....................
.......L.......G....
G...####............
#..##......G...D..G.
....#....###########
...X#..D............
########............
.......###########..
....................
...................#
....................
1..G...G..G...G..G..
#..#...#..#...#..#..
#LG#...#LG#...#GL#..
####SSS####SSS####SS