#..................#
#......D...........#
#.....###..........#
##....#.....G......#
#..G..#.....#......#
#.....#............#
#....##G......G....#
#.....#............#
#.....##.......#...#
##.G..#............#
#.....#....G.......#
#....##....#.......#
#.....#............#
#1....#...........X#
####SS#SSSSSSSSSSS##
