....................
.......L.......G....
G...####............
#..##......X...D..G.
....#....###########
...X#..D............
########............
.......###########..
....................
...................#
....................
1..G...G..G...G..G..
#..#...#..#...#..#..
#LG#...#LG#...#GL#..
####SSS####SSS####SS
