....................
....................
....................
....................
....................
....................
....................
....................
....................
....................
....................
....................
....................
.1...............X..
####################